Chapter 1 : Footsteps of fate
01000703
10 15
835 15 832 833 834 718 67 684 685 688 67 601 559 589 559
867 889 864 865 866 67 67 67 70 135 75 600 64 65 431
112 15 71 780 67 67 718 676 102 81 718 2 74 15 64
718 168 103 70 75 67 67 132 674 102 77 600 106 166 135
67 67 780 102 109 780 67 718 132 67 67 599 630 14 102
67 67 67 780 67 67 67 132 718 67 67 76 2 102 79
781 67 782 815 67 67 718 67 782 783 67 67 599 630 104
846 70 75 846 67 67 780 66 67 846 67 100 67 601 106
100 166 77 718 78 780 718 780 67 67 67 67 67 604 56
853 780 162 70 6 73 780 132 718 67 53 58 55 380 381
