Chapter 2 : Sword of Spirits
0a000b0c
10 15
270 273 209 133 194 224 108 38 556 814 774 913 774 877 524
230 231 133 133 133 224 224 168 588 873 656 624 686 842 524
133 133 128 128 75 133 133 224 777 876 688 627 689 842 524
133 133 133 168 137 194 133 174 844 841 719 876 719 877 524
199 194 133 106 173 133 224 108 556 877 879 812 879 812 524
337 273 199 194 133 502 161 133 556 877 842 841 841 842 524
230 305 338 224 133 534 69 133 748 747 484 877 484 750 749
97 97 238 133 499 566 101 225 780 778 774 877 774 814 781
133 68 224 198 531 69 226 227 224 4 761 760 224 3 194
97 133 198 790 531 69 225 35 133 194 230 726 762 224 70
